1111111111111
1EP00C00000C1
1111111111111
